11
11
###########
#1   B   2#
#         #
# BC+++C B#
# B+++++  #
#  ++@++  #
#  +++++  #
#  C+++C  #
#      B  #
#2  BB   1#
###########

background: ,
ammo: 100
life: 6
bombs: 2