20
16
####################
#........B.........#
#...$........&.....#
#.........B.......##
#..................#
#...++++OOOO++++...#
#...........B....B.#
#**...B............#
#####.....@....O...#
#.....B........O...#
#..............O...#
#...++++OOOO++++...#
#..................#
#...&....B...&.....#
#...............B.*#
####################