30
10
##############################
#....B.....O...**B...#...1...#
#..........O.........#.......#
#....#.....bB...O....#....#..#
#.@B.+..1.......O..2...B..#..#
#....+..........O....O....#..#
#....#.....#....O....O....B..#
#.....B....#.........O.......#
#..........#...bBb...O...1...#
##############################