20
10
####################
#.B............BB..#
#......1...2...BB..#
#...#...OOO...M....#
#.B.A.....BB..A....#
#.@.A.........A....#
#...#...XXX...M....#
#...b..1...2....B..#
#..bb.........b....#
####################