20
10
####################
#.B............BB..#
#......&...%...BB..#
#...#...OOO...M....#
#.B.+.....BB..+....#
#.@.+.........+....#
#...#...XXX...M....#
#...b..&...%....B..#
#..bb.........b....#
####################