16
10
################
#....BB........#
#.@............#
#.........b....#
#.....**..b....#
#...B..........#
#...B........&.#
#...........&..#
#.....bC......*#
################