20
16
####################
#........B.........#
#...3........1.....#
#.........B.......##
#..................#
#...AAAAOOOOAAAA...#
#...........B....B.#
#**...B............#
#####.....@....O...#
#.....B........O...#
#..............O...#
#...AAAAOOOOAAAA...#
#...2..............#
#........B...1.....#
#...............B.*#
####################