30
10
##############################
#....B.....O...**B...#...&...#
#..........O.........#.......#
#....#.....bB...O....#....#..#
#.@B.+..&.......O..%...B..#..#
#....+..........O....O....#..#
#....#.....#....O....O....B..#
#.....B....#.........O.......#
#..........#...bBb...O...&...#
##############################