20
16
####################
#..............&...#
#++++M.M.MMMMMMMMM.#
#....M.M.......BBM.#
#.&..M.MMMMMMMMMMM.#
#....M.+....M....M.#
#....M.+..&.M.BB.M.#
#...........M.BB...#
#M+MMM.+..&.M.bB.M.#
#....M.+....M....M.#
#.&..M.MBBMMMMMMMM.#
#.BB.M.MMMM......M.#
#....M......M..M...#
###.#MMMMMMMM..MMMM#
#...........@......#
####################