20
16
####################
#..............1...#
#AAAAM.M.MMMMMMMMM.#
#....M.M.......BBM.#
#.1..M.MMM.MMMMMMM.#
#....M.A.........M.#
#....M.A..1.M.BB.M.#
#...........M.BB...#
#MAMMM.A..1.M.bB.M.#
#....M.A....M....M.#
#.2..M.MBBMAMMMMMM.#
#.BB.M.MMMM......M.#
#....M......M..M...#
###.#M.MMMMMM..MMMM#
#...........@......#
####################