30
10
##############################
#....B.....O...**B...#...1...#
#..........O.........#.......#
#....#.....bB...O....#....#..#
#.@B.A..1.......O..2...B..#..#
#....A..........O....O....#..#
#....#.....#....O....O....B..#
#.....B....#.........O.......#
#..........#...bBb...O...1...#
##############################