20
16
####################
#..............1...#
#++++M.M.MMMMMMMMM.#
#....M.M.......BBM.#
#.1..M.MMM.MMMMMMM.#
#....M.+.........M.#
#....M.+..1.M.BB.M.#
#...........M.BB...#
#M+MMM.+..1.M.bB.M.#
#....M.+....M....M.#
#.2..M.MBBM+MMMMMM.#
#.BB.M.MMMM......M.#
#....M......M..M...#
###.#M.MMMMMM..MMMM#
#...........@......#
####################