10
10
##########
#bbbb@bbb#
#...bbb..#
#BBBB.BBB#
#BBB.....#
#..AAAAA.#
#..AA2AA.#
#..AA3AA.#
#..AA2AA.#
##########