5
5
#####
#.@.#
#+++#
#.&*#
#####