10
10
##########
#***,,.,*#
#,,****,,#
#,,,,.,.,#
#,3CCDC,,#
#,*Dk@D,,#
#,2CDDC,,#
#,,3**,,,#
#,**.,**,#
##########
