5
5
#####
#.@.#
#+++#
#.2*#
#####