20
16
####################
#.k.1M.............#
#.B..M...B..B....1.#
#....M.............#
#....M1............#
#....MOOOOOOOOOOO..#
#.B..M1............#
#....MMM...........#
#MMM..MMMM....MM.MM#
#MMMM....MM.1MMMDMM#
#+++++..++++++++...#
#........B.........#
#....@.............#
#...........bbB....#
#...B..............#
####################