20
16
####################
#...&M.............#
#.B..M...B..B......#
#....M.............#
#....M&............#
#....MOOOOOOOOOOO..#
#.B..M&............#
#....MMM...........#
#MMM..MMMM....MM.MM#
#MMMM....MM.&MMM.MM#
#+++++..+++++++++..#
#........B.........#
#....@.............#
#.............B....#
#...B..............#
####################