5
5
#####
#.@.#
#AAA#
#.2*#
#####