10
10
##########
#bbbb@bbb#
#...bbb..#
#BBBB.BBB#
#BBB.....#
#..+++++.#
#..++2++.#
#..++3++.#
#..++2++.#
##########