10
10
##########
#bbbb@bbb#
#...bbb..#
#BBBB.BBB#
#BBB.....#
#..+++++.#
#..++$++.#
#..++&++.#
#..++$++.#
##########