10
10
##########
#***,,.,*#
#,,****,,#
#,,,,.,.,#
#,$DDDDD,#
#,*DD@kD,#
#,$DDDDD,#
#,$,**,,,#
#,**.,**,#
##########
