10
10
##########
#$,,,,%,*#
#,,,$,,,,#
#,,,,$,,,#
#,,MMDMM,#
#,,Mk@kM,#
#,$MMDM%,#
#,$,,,,,,#
#,,,,,%,,#
##########
background: ,