12
12
MMMMMMMMMMMM
M...**.....M
M...C...BB.M
M.@.#...Bb.M
M...C......M
M..........M
MXXXC..CXXXM
M....1.*...M
M...#....2.M
M.1.#......M
M.....BB...M
MMMMMMMMMMMM