12
12
MMMMMMMMMMMM
M...**.....M
M...C...BB.M
M.@.#...Bb.M
M...C......M
M..........M
MXXXC..CXXXM
M....&....*M
M...#....%.M
M.&.#......M
M.....BB...M
MMMMMMMMMMMM