20
11
####################
#.&....B...........#
#..B...............#
#..............b...#
#...B.B.......BB...#
#.........@...BB...#
#.B................#
#...+++............#
#B.............OOO.#
#B.....**.......&..#
####################